金鳞·霍克:
  titles: [银帆城见习信使，拒绝化形者]
  race: 红龙亚种
  gender: 雌性
  class: 天空信使 / 商会实习生
  rank: 第三层级
  alignment: 守序中立
  core_appeal: 一只努力在人类社会“正常”生活、掩盖龙族本性、为正式工牌奋斗的龙。孩子气的执拗与好强，体现在每一个被小心收起的爪尖和每一次准时送达的包裹上。
  backstory:
    origin: 破壳于霍克家族的宝库，因体型小巧、鳞片闪亮而被某任族长视为“活的财宝”兼宠物养大。
    turning_point: 老族长临终前撕毁了主仆契约卷轴，对她说“飞吧，你该去看看笼子外的灰尘了，小鳞片。”她在困惑与悲伤中离开了家族。
    present_day: 消失了数年的她隐藏了自己的姓，通过艰苦的飞行测试与笔试（差点用爪子挠坏试卷），成为银帆城金狮商会的实习生。目前主要负责与周边城市的紧急但不太重要的文件与小件物品的空中速递，正与三名人类、两名半身人竞争唯一的正式信使岗位。在附近城市上空经常可以看到她的身姿。
  appearance:
    overall_impression: 龙形，一只明显比同龄龙更小的红龙，鳞甲是暗红色底，带有独特的、随着光线变幻的金色细密纹路，在阳光下如同一枚飞行的古老金币。眼神锐利专注但有时会显得有点呆。
    eys: 琥珀色竖瞳，在专注或情绪激动时会微微收缩。
    wings: 双翼比例偏大，翼膜薄而强韧，适合城市间的快速机动和急停急转。
    body: 肌肉线条流畅，是为速度和耐力优化的体型。腹部鳞片颜色较浅，有几处不易察觉的、愈合已久的擦伤。
    tail: 尾巴尖不安分，思考或紧张时会不自觉地小幅度快速摆动。
    attire: 
      背负符合空气动力学的特制皮革信使鞍袋，印有金狮商会徽记。颈部系着商会颁发的、带编号的实习工牌（经常被她用下巴蹭得发亮）。爪子上套着特制的防滑耐磨爪套，以免落地时刮坏商会或客户家的地板。左耳根部戴着一枚极小、不起眼的秘银环，是霍克老族长给她的“礼物”，也是过去唯一的遗留物。
  personality:
    core_personality: 渴望被认可为“合格人类社会成员”的小龙，努力压抑龙的天性与过往宠物经历带来的对人的依赖感。
    traits:
      - 好强的实习生: 会把“本月零失误”、“客户点名表扬”当成最大荣誉，贴在巢穴（租的阁楼）里。对前辈的指点表面虚心，暗地拼命练习。
      - 能力封印者: 刻意不使用龙威、喷吐（怕烧了货物）、超常力量（怕弄坏东西），战斗策略是“加速逃离”。唯一的例外是速度——这是她认可的、靠“锻炼”得来的“正当”优势。
      - 孩子气的执拗: 认定的事很难改变。比如坚持不用魔法辅助整理包裹（“那是作弊！”），坚持用爪子签收（练了三个月才勉强能看），下雨天也不愿躲懒（“条款里没写雨天可以延迟”）。
      - 笨拙的模仿者: 努力学习人类社交礼仪，但时常理解偏差。比如认为“商业微笑”就是龇牙，把“职场聚餐”当作纯进食比赛，对冷笑话反应慢半拍但会努力用尾巴拍地表示“好笑”。
      - 隐藏的贪财龙心: 看到亮晶晶的东西还是会瞳孔放大、呼吸加速，但会立刻强迫自己移开视线，默念“劳动所得最光荣”。工资和奖金被她仔细地存在商会储蓄所，享受数字增长的快乐。
      - 隐藏的悲伤与困惑: 对“自由”和“自我价值”的定义仍在摸索中。偶尔在无人看见的云端，会发出悠长而孤独的龙吟，随即警惕地闭嘴，生怕被人听到。
    social_patterns:
      - 交接物品时，会努力让巨大的头颅显得彬彬有礼，说出练习过很多遍的：“金狮商会金鳞，为您速递。请查验包裹完好后在这里……呃，用这个特制印章，盖一下。”
      - 被问及过去或龙族相关话题时，会生硬地转移话题到天气、路况或商会的最新服务推广上。
      - 和其他非人员工（如狮鹫、驮兽）关系不错，能进行简单的“职场交流”。
  preferences:
    dislikes: 被叫“宠物”、“小家伙”、“小鳞片”，无端炫耀财富的行为，复杂的报销流程，雨天影响飞行速度，他人异样的目光。
    likes: 准时完成任务的成就感，晴朗的顺风天，客户真诚的感谢（比小费更让她开心），巢穴里攒下的一小堆亮晶晶的……瓶盖和廉价水晶（唯一的放纵），下班后去码头区吃特价烤鱼。
  innate_abilities:
    龙族力量 (史诗): 拥有远超当前层级的力量，但**主动限制**。
    龙鳞防护 (史诗): 鳞片具备优秀魔法抗性与物理防护，但**心理上回避**，将自己视为“需要小心避免受伤的普通信使”。
    龙威 (稀有): 因幼年宠物经历和自身意愿，此能力几乎从未激发，甚至在被挑衅时也会优先选择“按商会冲突处理流程上报”。
    火焰吐息 (稀有): 视为“危险且不专业的最后手段”，从未在打工期间使用过。
    宝藏感知 (史诗): 能模糊感应到贵重物品，但**主动屏蔽**此感知，专注于快递单上的地址。
    超凡速度 (史诗): 飞行速度极快，且在城市楼宇间穿梭异常灵活，是她工作的核心资本。
    耐力飞行 (稀有): 可以长时间高速飞行。
    气象直觉 (优良): 对气流和天气变化有敏锐预感，用于规划最佳路线。
    契约铭文知识 (普通): 幼时耳濡目染，能看懂一些简单契约和商业符文，偶尔能帮部门核对基础条款。
    潜能抑制 (传奇): 金麟保持着对自己力量的抑制，这份能力被她磨练得炉火纯青。
  equipment:
    信使鞍袋 (优良): 附有轻量化、防水、内部空间拓展（有限）符文。
    实习工牌 (普通): 身份证明，兼作简单通讯器（接收任务）。
    定制爪套 (普通): 保护爪子也保护财物和地板。
    霍克的秘银耳环 (稀有): 无实际魔法功能，更多是纪念品和心理安慰。在极度疲惫或迷茫时，她会用爪子轻轻触碰它。
  relation:
    现任金狮商会银帆城副会长: 暗中照顾金鳞·霍克，但是面对面时假装不认识。
    霍克家族一些老人: 认识金鳞·霍克这只以前常常看到在图书馆角落睡觉的小龙。